ZraI	GACGTC
XmaI	CCCGGG
TspMI	CCCGGG
StyD4I	CCNGG
SfoI	GGCGCC
SfcI	CTRYAG
SbfI	CCTGCAGG
Sau3AI	GATC
PspOMI	GGGCCC
PspGI	CCWGG
PmlI	CACGTG
PluTI	GGCGCC
PflFI	GACNNNGTC
PciI	ACATGT
PaeR7I	CTCGAG
NsiI	ATGCAT
NgoMIV	GCCGGC
NdeII	GATC
NciI	CCSGG
MspI	CCGG
MspA1I	CMGCKG
MscI	TGGCCA
MlyI	GAGTC
MluCI	AATT
KasI	GGCGCC
HpyCH4V	TGCA
HpyCH4IV	ACGT
HpyCH4III	ACNGT
HpyAV	CCTTC
Hpy188III	TCNNGA
Hpy166II	GTNNAC
HinP1I	GCGC
HincII	GTYRAC
FspI	TGCGCA
FatI	CATG
Eco53kI	GAGCTC
EarI	CTCTTC
EagI	CGGCCG
DraI	TTTAAA
DpnII	GATC
CviQI	GTAC
CviKI-1	RGCY
CviAII	CATG
BtsCI	GGATG
BtgI	CCRYGG
Bsu36I	CCTNAGG
BstZ17I	GTATAC
BstYI	RGATCY
BstUI	CGCG
BstNI	CCWGG
BstBI	TTCGAA
BstAPI	GCANNNNNTGC
BssSI	CACGAG
BssKI	CCNGG
BssHII	GCGCGC
BsrGI	TGTACA
BsrFI	RCCGGY
BspQI	GCTCTTC
BspEI	TCCGGA
BspDI	ATCGAT
BspCNI	CTCAG
Bsp1286I	GDGCHC
BsoBI	CYCGRG
BsmFI	GGGAC
BsmBI	CGTCTC
BslI	CCNNNNNNNGG
BsiWI	CGTACG
BsiHKAI	GWGCWC
BsiEI	CGRYCG
BsaWI	WCCGGW
BsaJI	CCNNGG
BsaI	GGTCTC
BsaHI	GRCGYC
BpuEI	CTTGAG
BpmI	CTGGAG
BmtI	GCTAGC
BmrI	ACTGGG
BmgBI	CACGTC
BlpI	GCTNAGC
BfuCI	GATC
BfuAI	ACCTGC
BfaI	CTAG
BcoDI	GTCTC
BceAI	ACGGC
BbsI	GAAGAC
BanI	GGYRCC
BaeGI	GKGCMC
AsiSI	GCGATCGC
AseI	ATTAAT
ApeKI	GCWGC
AlwI	GGATC
AleI	CACNNNNGTG
AhdI	GACNNNNNGTC
AfeI	AGCGCT
AcuI	CTGAAG
AccIII	TCCGGA
AbaSI	C
AflIII	ACRYGT
SexAI	ACCWGGT
PshAI	GACNNNNGTC
DdeI	CTNAG
AvaII	GGWCC
AgeI	ACCGGT
AvaI	CYCGRG
ScrFI	CCNGG
BsmI	GAATGC
NarI	GGCGCC
SwaI	ATTTAAAT
HaeII	RGCGCY
AflII	CTTAAG
SfaNI	GCATC
AclI	AACGTT
FauI	CCCGC
HgaI	GACGC
MfeI	CAATTG
PsiI	TTATAA
PspXI	VCTCGAGB
Tth111I	GACNNNGTC
FokI	GGATG
PacI	TTAATTAA
HphI	GGTGA
AatII	GACGTC
MboII	GAAGA
ApaLI	GTGCAC
NaeI	GCCGGC
SnaBI	TACGTA
BstEII	GGTNACC
StyI	CCWWGG
BclI	TGATCA
RsaI	GTAC
BglI	GCCNNNNNGGC
SfiI	GGCCNNNNNGGCC
MseI	TTAA
ClaI	ATCGAT
SacII	CCGCGG
StuI	AGGCCT
AccI	GTMKAC
SpeI	ACTAGT
HaeIII	GGCC
PvuI	CGATCG
HhaI	GCGC
NdeI	CATATG
XhoI	CTCGAG
SacI	GAGCTC
ApaI	GGGCCC
MluI	ACGCGT
DpnI	GATC
NruI	TCGCGA
HpaI	GTTAAC
SphI	GCATGC
EcoRV	GATATC
MboI	GATC
ScaI	AGTACT
NcoI	CCATGG
NotI	GCGGCCGC
NheI	GCTAGC
TaqI	TCGA
SspI	AATATT
HinfI	GANTC
BglII	AGATCT
PvuII	CAGCTG
AluI	AGCT
BamHI	GGATCC
EcoRI	GAATTC
HindIII	AAGCTT
KpnI	GGTACC
PstI	CTGCAG
SalI	GTCGAC
SmaI	CCCGGG
XbaI	TCTAGA
XmnI	GAANNNNTTC
RsrII	CGGWCCG
AciI	CCGC
AlwNI	CAGNNNCTG
ApoI	RAATTY
AscI	GGCGCGCC
AvrII	CCTAGG
BbvI	GCAGC
BbvCI	CCTCAGC
BccI	CCATC
BciVI	GTATCC
BsaAI	YACGTR
BsaBI	GATNNNNATC
BseRI	GAGGAG
BseYI	CCCAGC
BsgI	GTGCAG
BsmAI	GTCTC
BspHI	TCATGA
BspMI	ACCTGC
BsrI	ACTGG
BsrBI	CCGCTC
BsrDI	GCAATG
BtgZI	GCGATG
BtsIMutI	CAGTG
BtsI	GCAGTG
Cac8I	GCNNGC
DrdI	GACNNNNNNGTC
EciI	GGCGGA
EcoNI	CCTNNNNNAGG
Fnu4HI	GCNGC
FseI	GGCCGGCC
FspEI	CC
Hpy99I	CGWCG
Hpy188I	TCNGA
LpnPI	CCDG
MmeI	TCCRAC
MslI	CAYNNNNRTG
MspJI	CNNR
MwoI	GCNNNNNNNGC
NlaIII	CATG
NlaIV	GGNNCC
NmeAIII	GCCGAG
NspI	RCATGY
PflMI	CCANNNNNTGG
PleI	GAGTC
PmeI	GTTTAAAC
PpuMI	RGGWCCY
SapI	GCTCTTC
SgrAI	CRCCGGYG
SmlI	CTYRAG
TfiI	GAWTC
TseI	GCWGC
Tsp45I	GTSAC
TspRI	CASTGNN
XcmI	CCANNNNNNNNNTGG
EcoP15I	CAGCAG
BanII	GRGCYC
EaeI	YGGCCR
Sau96I	GGNCC